16 150
100 100
100 100 100 100 100 100 100 100 100 100 100 100 100 100 100 100
100 100 100 100 100 100 101 101 101 101 101 101 101 101 101 101
100 100 100 100 100 100 100 101 100 100 100 100 100 100 100 100
100 100 100 100 100 100 100 101 100 100 100 100 100 100 100 100
101 101 101 101 101 101 101 101 099 099 099 099 101 101 101 101
099 099 099 099 099 099 099 099 099 099 099 101 099 099 099 099
099 099 099 099 099 099 099 099 099 099 099 099 099 099 099 099
099 099 099 099 099 099 099 099 101 101 101 101 099 099 099 099
099 099 099 099 099 099 099 099 101 101 101 099 099 099 099 099
099 099 099 099 099 099 101 101 101 101 099 099 099 099 099 099
099 099 099 099 099 099 099 099 099 099 099 099 099 099 099 099
099 099 099 101 101 101 099 099 099 099 099 099 099 099 099 099
099 099 099 099 101 099 099 099 099 099 101 101 101 101 101 101
101 101 101 101 101 099 099 099 099 099 101 101 099 099 099 099
099 099 099 099 099 099 099 101 101 101 101 099 099 099 099 099
099 099 099 099 099 099 099 099 099 099 099 099 099 099 099 099
099 099 099 099 101 101 101 101 099 099 099 099 099 099 099 099
099 099 099 101 099 099 099 099 099 099 099 099 099 099 099 099
099 099 099 099 099 099 099 099 099 099 099 099 099 099 099 099
099 099 101 099 099 099 099 099 099 099 099 099 099 099 099 099
099 099 099 101 099 099 099 099 099 099 099 099 099 099 099 099
099 099 099 099 099 101 099 099 101 099 099 101 099 099 099 099
099 099 099 099 099 099 101 099 099 101 099 099 101 099 099 099
099 099 099 099 099 099 099 101 099 099 099 099 099 099 099 099
099 099 099 099 099 099 099 099 099 099 099 099 099 101 099 099
099 101 101 101 101 101 099 099 101 099 099 101 099 101 099 099
099 101 099 099 099 101 099 099 101 099 099 101 099 101 099 099
099 101 099 099 099 101 099 101 101 099 099 101 099 099 099 099
101 101 099 101 101 101 099 099 101 099 099 101 099 099 099 099
099 099 099 099 099 099 101 099 099 099 099 099 099 099 099 099
099 099 099 099 099 099 099 099 099 099 099 099 099 099 099 099
101 101 101 101 101 101 101 101 099 099 099 099 099 099 099 099
099 099 099 099 099 099 099 099 099 099 099 099 099 099 099 099
099 099 099 099 099 099 099 099 101 099 099 099 099 099 099 099
099 099 099 099 099 099 099 099 099 099 101 101 099 099 099 099
099 099 099 099 099 099 099 101 101 099 099 099 099 099 099 099
099 099 099 099 099 099 099 099 099 099 101 099 099 099 099 099
099 099 099 099 099 099 099 099 099 099 099 099 099 099 099 099
101 099 099 099 099 099 101 101 101 101 099 101 101 101 101 101
101 099 099 099 099 099 099 099 099 099 099 099 099 099 099 099
101 099 099 099 099 099 099 099 099 099 101 099 099 099 099 099
101 099 099 099 099 099 099 099 099 099 099 099 101 099 099 099
101 099 099 099 099 099 099 099 099 099 099 099 101 099 099 101
101 099 099 099 099 099 101 101 101 101 101 101 101 101 099 101
101 099 099 099 099 099 099 101 099 099 099 099 099 099 099 101
101 099 099 101 101 101 101 101 099 099 099 099 099 099 101 101
101 099 101 101 099 099 099 099 099 101 101 101 101 101 101 101
101 099 099 101 099 099 099 099 099 099 099 099 099 099 101 101
101 101 099 101 099 099 099 099 101 099 099 099 099 099 101 101
101 099 099 101 099 099 099 101 101 101 099 099 099 099 101 101
101 099 101 101 099 099 099 099 099 099 101 099 099 099 101 101
101 099 099 101 099 099 099 099 099 099 099 099 099 099 101 101
101 101 099 101 099 099 099 099 099 101 101 101 101 099 101 101
101 099 099 101 099 099 099 099 101 099 099 099 099 099 101 101
101 099 101 101 099 099 099 099 099 099 099 099 099 099 101 101
101 099 099 101 101 101 101 101 099 099 099 099 099 099 101 101
101 101 099 101 099 099 099 099 101 099 099 099 099 099 101 101
101 099 099 101 099 099 099 099 099 099 099 099 099 099 099 101
101 099 101 101 099 099 099 099 101 101 101 101 099 099 099 101
101 099 099 101 099 099 099 101 099 099 099 099 099 099 099 101
101 101 099 101 099 099 099 099 099 099 099 099 099 099 099 101
101 099 099 101 101 101 101 101 099 099 099 099 099 099 099 101
101 099 101 101 099 099 099 099 101 099 099 099 099 099 099 101
101 099 099 101 099 099 099 099 099 099 099 099 099 099 099 101
101 101 099 101 099 099 099 099 099 101 101 101 101 099 099 101
101 099 099 101 099 099 099 099 099 099 099 099 099 099 099 101
101 099 101 101 099 099 099 099 099 099 099 099 099 099 101 101
101 099 099 101 099 099 099 099 099 099 099 099 099 099 101 101
101 101 099 101 099 101 099 099 099 099 099 099 099 101 101 101
101 099 099 101 099 099 099 101 101 101 101 101 101 101 101 101
099 099 101 101 101 099 099 101 101 099 099 099 101 099 099 099
099 099 099 101 099 099 101 101 101 099 101 101 099 099 099 099
101 101 101 101 099 099 099 101 101 099 099 099 099 099 101 101
101 101 101 101 099 101 099 101 101 101 101 099 101 101 101 101
101 101 101 101 099 099 099 101 101 099 099 099 099 099 101 101
101 101 101 101 101 099 099 101 101 099 099 101 099 099 101 101
099 099 099 099 099 099 101 099 099 099 101 101 099 099 099 099
099 099 099 099 099 099 099 099 099 099 099 099 099 099 099 099
099 099 099 099 099 101 099 099 099 101 099 099 099 099 099 099
099 099 099 099 101 101 101 101 101 101 101 099 099 099 099 099
099 099 099 099 099 099 099 099 099 099 099 101 099 099 099 099
099 099 099 101 099 099 099 099 099 099 099 099 099 099 099 099
099 099 099 101 101 101 101 101 099 099 101 101 101 101 099 099
099 099 099 099 099 099 099 099 099 099 099 099 099 099 099 099
099 099 099 099 099 099 099 099 101 101 099 099 101 101 101 101
099 099 099 099 099 099 099 099 099 099 099 099 099 099 099 099
099 099 099 099 099 099 099 099 099 099 101 099 099 099 099 099
099 099 099 099 099 099 101 101 099 099 101 101 099 099 099 099
099 099 099 099 099 099 099 099 099 101 099 099 099 099 099 099
099 099 099 099 099 099 099 099 099 099 099 099 099 099 099 099
099 099 099 099 099 099 099 101 101 099 099 101 101 099 099 099
099 099 099 099 099 099 101 099 099 099 099 099 099 099 099 099
099 099 099 099 099 099 099 099 099 101 099 099 099 099 099 099
099 099 099 099 099 101 101 101 101 101 099 099 099 099 099 099
099 099 099 099 101 099 099 099 099 099 099 099 099 099 099 099
099 099 099 099 099 099 099 099 099 099 099 099 099 099 099 099
099 099 099 101 101 101 101 099 099 101 101 101 101 099 099 099
099 099 099 099 099 099 099 101 099 099 099 099 099 099 101 099
099 099 099 099 099 099 099 099 099 099 099 099 099 099 099 099
099 099 099 099 099 099 099 101 101 099 099 101 101 101 101 099
099 099 099 099 099 099 101 099 099 099 101 099 099 099 099 099
099 099 099 099 099 099 099 099 099 099 099 099 099 099 099 099
099 099 099 099 099 101 101 101 099 101 101 099 099 099 099 099
099 099 099 099 101 099 099 099 099 099 099 099 099 099 099 099
099 099 099 099 099 099 099 099 099 099 099 099 099 099 099 099
099 099 101 101 099 099 099 099 099 099 099 099 099 099 099 099
099 099 101 101 101 101 101 099 099 099 099 099 099 099 099 099
099 099 099 099 099 099 099 099 099 099 099 099 099 099 099 099
099 099 099 099 099 101 101 101 101 101 099 099 099 099 099 099
099 099 099 099 099 099 099 099 099 099 099 099 099 099 099 099
099 099 099 099 099 099 099 099 101 101 101 101 101 099 099 099
099 099 099 099 099 099 099 099 099 099 099 099 099 099 099 099
101 101 101 101 099 099 099 099 099 099 099 101 101 101 101 101
099 099 099 099 099 099 099 099 099 099 099 099 099 099 099 101
099 099 101 101 101 101 101 099 099 099 099 099 099 099 099 101
099 099 099 099 099 099 099 099 099 099 099 099 099 099 099 101
099 099 099 099 099 101 101 101 101 101 099 099 099 099 099 101
099 099 099 099 099 099 099 099 099 099 099 099 099 099 099 101
099 099 099 099 099 099 099 099 099 101 101 101 099 099 099 101
099 099 099 099 099 099 099 099 099 099 099 099 099 099 099 101
099 099 099 099 099 099 099 099 099 099 099 099 101 101 101 101
099 099 099 099 099 099 099 099 099 099 099 099 099 099 099 099
099 099 099 099 099 099 099 099 099 101 101 101 101 101 099 099
099 099 099 099 099 099 099 099 099 099 099 099 099 099 099 099
099 099 099 099 099 099 101 101 101 101 101 099 099 099 099 099
099 099 099 099 099 099 099 099 099 099 099 099 099 099 099 099
099 099 099 101 101 101 101 101 099 099 099 099 099 099 099 099
099 099 099 099 099 099 099 099 099 099 099 099 099 099 099 099
099 099 101 099 099 099 099 099 099 099 099 099 099 099 099 099
101 101 101 099 099 099 099 099 099 099 099 099 099 099 099 099
101 099 099 099 099 099 099 099 099 099 099 099 099 099 099 101
101 099 099 099 099 099 099 099 099 099 099 099 099 099 101 101
101 101 101 101 099 099 099 099 101 101 101 101 101 101 101 101
099 099 099 101 099 099 101 099 099 099 099 099 099 099 099 099
099 099 099 101 099 101 099 099 099 099 099 099 099 099 099 099
101 101 101 099 099 099 099 099 099 099 099 099 099 099 101 101
101 101 101 101 101 101 101 101 101 101 099 099 099 099 101 099
101 099 099 099 099 099 099 099 099 099 101 099 099 101 101 099
101 099 099 099 099 099 099 099 099 099 099 099 099 099 101 099
101 099 099 099 099 099 101 101 101 101 101 101 101 101 101 099
101 099 099 101 099 099 099 099 099 099 099 099 099 099 101 099
101 099 099 099 099 099 099 099 099 099 099 099 099 099 101 099
101 101 101 101 101 101 101 099 099 099 099 099 099 099 101 099
101 099 099 099 099 099 099 101 101 101 099 099 099 099 101 099
101 099 099 099 099 099 099 099 099 099 099 099 101 099 101 099
101 099 099 099 099 099 099 099 099 099 099 099 099 099 101 099
101 099 099 099 099 099 099 099 099 099 099 101 101 101 101 099
101 101 101 101 101 099 099 099 099 099 099 101 099 099 099 099
101 099 099 099 099 101 101 101 101 101 101 099 099 099 099 099
101 099 099 099 099 099 099 099 099 099 099 099 099 099 099 099