300 12
100 100
078 112 112 112 112 112 112 112 112 112 112 112 112 112 112 112 112 112 112 112 112 112 112 112 112 112 112 112 112 112 112 112 112 112 112 112 112 112 112 112 112 112 112 112 112 112 112 112 112 112 112 112 112 112 112 112 112 078 112 112 112 112 112 112 112 112 112 112 112 112 112 112 112 112 112 112 112 112 112 112 112 112 112 112 112 112 112 112 112 112 112 112 112 112 112 112 112 112 112 112 112 112 112 112 112 112 112 112 112 112 112 112 112 112 112 112 112 112 112 112 112 112 112 112 112 112 112 112 112 112 112 112 112 112 112 112 112 112 112 112 112 112 112 112 112 112 112 112 112 112 112 112 112 112 112 112 112 112 112 112 112 078 112 112 112 112 112 112 112 112 112 112 112 112 112 112 112 112 112 112 112 112 112 112 112 112 112 112 112 112 112 112 112 112 112 112 112 112 112 112 112 112 112 112 112 112 112 112 112 112 112 112 112 112 112 112 112 112 112 112 112 112 112 112 112 112 112 112 112 112 112 112 112 112 112 112 112 112 112 112 112 112 112 112 112 112 112 112 112 112 112 112 112 112 112 112 112 112 112 112 112 112 112 112 112 112 112 112 112 112 112 112 112 112 112 112 112 112 112 112 112 112 112 112 112 112 112 112 112 112 112 112 112 112 112 112 112 112 112 078
078 112 112 112 112 112 112 112 112 112 112 112 112 112 112 112 112 112 112 112 112 112 112 112 112 112 112 112 112 112 112 112 112 112 112 112 112 112 112 112 112 112 112 112 112 112 112 112 112 112 112 112 112 112 076 076 112 078 112 112 112 112 112 112 112 112 112 112 112 112 112 112 112 112 112 112 112 112 112 112 112 112 112 112 112 112 112 112 112 112 112 112 112 112 112 112 112 112 112 112 112 112 112 112 112 112 112 112 112 112 112 112 112 112 112 112 112 112 112 112 112 112 112 112 112 112 112 112 112 112 112 112 112 112 112 112 112 112 112 112 112 112 112 112 112 112 112 112 112 112 112 112 112 112 112 112 112 112 112 112 112 078 112 112 112 112 112 112 112 112 112 112 112 112 112 112 112 112 112 112 112 112 112 112 112 112 112 112 112 112 112 112 112 112 112 112 112 112 112 112 112 112 112 112 112 112 112 112 112 112 112 112 112 112 112 112 112 112 112 112 112 112 112 112 112 112 112 112 112 112 112 112 112 112 112 112 112 112 112 112 112 112 112 112 112 112 112 112 112 112 112 112 112 112 112 112 112 112 112 112 112 112 112 112 112 112 112 112 112 112 112 112 112 112 112 112 112 112 112 112 112 112 112 112 112 112 112 112 112 112 112 112 112 112 112 112 112 112 112 078
078 112 112 112 112 112 112 112 112 112 112 112 112 112 112 112 112 112 112 112 112 112 112 112 112 112 112 112 112 112 112 112 112 112 112 112 112 112 112 112 112 112 112 112 112 112 112 112 112 112 112 112 112 112 112 112 112 078 112 112 112 112 112 112 112 112 076 076 076 076 076 076 112 112 112 112 112 112 112 112 112 112 112 112 112 112 112 112 112 112 112 112 112 112 112 112 112 112 112 112 112 112 112 112 112 112 112 112 112 112 112 112 112 112 112 112 112 112 112 112 112 112 112 112 112 112 112 112 112 112 112 112 112 112 112 112 112 112 112 112 112 112 112 112 112 112 112 112 112 112 112 112 112 112 112 112 112 076 076 112 112 078 112 112 112 112 112 112 112 112 112 112 112 076 076 112 076 076 076 112 112 112 112 112 112 112 112 112 112 112 112 112 112 112 112 112 112 112 112 112 112 112 112 112 112 112 112 112 112 112 112 112 112 112 112 112 112 112 112 112 112 112 112 112 112 112 112 112 112 112 112 112 112 112 112 112 112 112 112 112 112 112 112 112 112 112 112 112 112 112 112 112 112 112 112 112 112 112 112 112 112 112 112 112 112 112 112 112 112 112 112 112 112 112 112 112 112 112 112 112 112 112 112 112 112 112 112 112 112 112 112 112 112 112 112 112 112 112 112 078
078 112 112 112 112 112 112 112 112 112 112 112 112 112 112 112 112 112 112 112 112 112 112 112 112 112 112 112 112 112 112 112 112 112 112 112 112 112 112 112 112 112 112 112 112 112 112 112 112 112 112 112 112 076 076 078 112 078 112 112 112 112 112 112 076 112 112 112 112 112 112 112 112 112 112 112 112 112 112 112 112 112 112 112 112 112 112 112 112 112 112 112 112 112 112 112 112 112 112 112 112 112 112 112 112 112 112 112 112 112 112 112 112 112 112 112 112 112 112 112 112 112 112 112 112 112 112 112 112 112 112 112 112 112 112 112 112 112 112 112 112 112 076 076 076 112 112 112 112 112 112 112 112 112 112 112 112 112 112 112 112 078 112 112 112 112 112 112 112 112 112 112 112 112 112 112 112 112 112 112 112 112 112 112 112 112 112 112 112 112 112 112 112 112 112 112 112 112 112 112 112 112 112 112 112 112 112 112 112 112 112 112 112 112 112 112 112 112 112 112 112 112 112 112 112 112 112 112 112 112 112 112 112 112 112 112 112 112 112 112 112 112 112 112 112 112 112 112 112 112 112 112 112 112 112 112 112 112 112 112 112 112 112 112 112 112 112 112 112 112 112 112 112 112 112 112 112 112 112 112 112 112 112 112 112 112 112 112 112 112 112 112 112 076 112 112 112 112 112 078
078 112 112 112 112 112 112 112 112 112 112 112 112 112 112 112 112 112 112 112 112 112 112 112 112 112 112 112 112 112 112 112 112 112 112 112 112 112 112 112 112 112 112 112 112 112 112 112 112 112 112 112 112 112 112 078 112 078 112 112 112 112 112 112 112 112 112 112 112 112 112 112 112 112 112 112 112 112 112 112 112 112 112 112 112 112 112 076 076 076 076 076 112 112 112 112 112 112 112 112 112 112 112 112 112 112 112 112 112 112 112 112 112 112 112 112 112 112 076 112 112 076 112 112 076 112 112 076 112 112 112 112 112 112 112 112 112 112 112 076 076 076 112 112 112 076 076 076 112 112 112 112 112 112 112 112 076 076 112 112 112 078 112 112 112 112 112 112 112 112 112 076 112 112 112 076 076 076 076 076 076 076 076 076 076 076 076 076 076 076 112 112 112 112 112 112 112 112 112 112 112 112 112 112 112 112 076 076 076 076 076 076 112 112 112 112 112 112 112 112 112 112 112 112 112 076 112 076 076 076 076 076 076 076 076 112 076 076 076 076 076 076 112 076 076 076 076 112 112 112 112 112 112 112 112 112 112 112 112 112 112 112 112 112 112 112 112 112 112 112 112 112 112 112 112 112 076 076 076 112 112 112 112 112 112 112 112 112 112 112 112 112 076 112 076 112 112 112 112 078
078 078 112 112 112 112 112 112 112 112 112 112 112 112 112 112 112 112 112 112 112 112 112 112 112 112 112 112 112 112 076 076 076 076 112 112 112 112 112 112 112 076 112 112 112 112 112 112 112 112 112 112 076 076 112 078 112 078 112 112 112 112 112 076 112 112 112 112 112 112 112 112 076 076 076 076 076 112 112 112 112 076 112 112 112 112 076 112 112 112 076 076 076 076 076 112 112 112 112 112 112 112 112 112 112 112 076 112 112 112 112 112 112 112 112 112 112 112 112 112 112 112 112 112 112 112 112 112 112 112 112 112 112 112 112 112 112 112 112 112 112 112 112 112 112 112 112 112 112 112 112 112 112 112 112 112 112 112 112 112 112 078 112 076 076 076 076 076 076 076 112 112 112 112 112 112 112 112 112 112 112 112 112 112 112 112 112 112 112 112 112 112 112 112 112 112 112 112 112 112 112 112 112 112 112 112 112 112 112 112 076 076 076 112 112 112 112 112 112 112 112 112 112 112 112 112 112 112 112 112 112 112 112 112 112 112 112 112 112 112 112 112 112 112 112 112 112 112 076 112 112 112 112 112 112 112 112 112 112 112 112 112 112 112 112 112 112 112 112 112 112 112 112 112 112 112 112 112 112 112 112 112 112 112 112 112 112 112 112 112 112 076 112 112 112 076 112 112 112 078
078 078 112 112 112 112 112 112 112 112 112 112 112 112 112 112 112 112 112 112 112 112 112 112 112 112 112 112 112 076 112 112 112 112 112 112 112 112 112 112 112 112 112 112 112 112 112 112 112 112 112 112 112 112 112 078 112 078 112 112 112 112 112 112 112 112 112 112 112 112 112 112 112 112 112 112 112 112 112 112 112 112 112 112 112 112 112 112 112 112 112 112 112 076 076 076 076 076 112 112 112 112 112 112 112 076 112 112 112 076 112 076 112 076 112 076 112 076 112 112 112 112 112 112 112 112 112 112 112 112 112 112 112 112 112 112 112 076 076 112 112 112 112 112 112 112 112 112 076 076 112 112 112 112 112 076 076 112 112 112 112 078 112 112 112 112 112 112 112 112 112 112 112 112 112 112 112 112 112 112 112 112 112 112 112 112 112 112 112 112 076 112 112 112 112 112 112 112 112 112 112 112 112 112 076 112 112 112 112 112 112 076 076 076 112 112 112 112 112 112 112 112 112 076 112 112 076 076 076 112 076 076 076 076 112 076 076 076 076 112 076 076 076 076 076 076 076 112 112 112 112 076 076 076 076 112 112 076 076 076 076 112 112 112 112 112 112 112 112 112 112 112 112 112 076 112 112 112 112 112 112 112 112 112 112 112 112 112 112 112 076 112 112 112 112 112 076 112 112 078
078 078 112 112 112 112 112 112 112 112 112 112 112 112 112 112 112 112 112 112 112 112 112 112 112 112 112 112 076 112 112 112 076 076 076 076 112 112 112 076 112 112 076 076 112 112 112 112 112 112 112 076 076 112 112 078 112 112 112 112 112 112 076 076 076 112 112 112 112 076 076 112 112 112 112 112 112 112 112 112 076 112 112 112 112 076 112 112 112 112 112 112 112 112 112 112 112 076 076 076 076 076 112 112 076 112 112 112 112 112 112 112 112 112 112 112 112 112 112 112 112 112 112 112 112 112 112 112 112 112 112 112 112 112 112 076 076 112 112 112 112 112 112 112 112 112 112 112 112 112 076 076 112 112 112 112 112 112 112 112 112 078 076 112 112 112 112 112 112 112 112 076 112 112 112 076 112 076 076 076 076 076 076 076 076 076 076 076 076 076 112 112 112 112 112 112 112 112 112 112 112 112 112 076 112 112 112 112 112 112 112 112 076 076 076 112 112 112 112 112 112 076 112 112 112 112 112 112 112 112 112 112 112 112 112 112 112 112 112 112 112 112 112 112 112 112 112 112 112 112 076 112 112 112 112 112 112 112 112 112 112 112 112 112 112 112 112 112 112 112 112 112 076 112 112 112 112 112 112 112 112 112 112 112 112 112 112 112 112 076 112 112 112 112 112 112 112 076 112 078
078 078 076 076 112 112 076 076 076 112 112 076 076 076 112 112 076 076 112 112 076 076 076 076 076 112 112 076 112 112 112 112 112 112 112 112 112 112 112 112 112 112 112 112 076 112 112 112 112 112 112 112 112 112 112 112 112 112 112 112 112 112 112 112 112 112 112 112 112 112 112 112 112 112 112 112 112 112 112 112 112 112 112 112 112 112 112 112 112 112 112 112 112 112 112 112 112 112 112 112 112 076 076 112 112 112 076 076 076 112 112 112 112 112 112 112 112 112 112 112 112 112 112 112 112 112 112 112 112 112 112 112 112 076 076 112 112 112 112 112 112 112 112 112 112 112 112 112 112 112 112 112 076 076 112 076 112 112 112 112 112 112 112 112 076 112 112 112 112 112 112 112 112 112 112 112 112 112 112 112 112 112 112 112 112 112 112 112 112 112 112 112 076 112 112 112 112 112 112 112 112 112 076 112 112 112 112 112 112 112 112 112 112 112 112 076 076 076 076 076 076 112 112 112 112 076 112 076 076 076 076 112 076 076 076 076 076 112 076 076 076 076 076 112 112 076 076 112 112 076 112 112 112 112 112 112 112 112 112 112 112 112 112 112 112 112 112 112 112 112 076 112 112 112 112 112 112 112 112 112 112 112 112 112 112 112 112 112 076 112 112 112 112 112 112 112 112 076 112 078
112 112 112 112 112 112 112 112 112 112 112 112 112 112 112 112 112 112 112 112 112 112 112 112 112 112 112 112 112 112 112 112 112 112 076 076 076 076 112 112 112 112 112 112 112 112 112 112 112 112 076 076 112 112 112 112 112 112 076 076 076 112 112 112 112 076 076 076 112 112 112 112 112 112 112 112 112 112 076 112 112 112 076 076 076 076 112 112 112 112 112 112 112 112 112 112 112 112 112 112 112 112 112 112 112 112 112 112 112 112 112 112 112 112 112 112 112 112 112 112 112 112 112 112 112 112 112 112 112 076 076 076 076 076 112 112 112 112 112 112 112 112 112 112 112 112 112 112 112 112 112 112 112 112 112 112 112 112 112 112 112 112 112 112 112 112 112 112 112 112 112 112 076 076 076 076 076 076 076 112 112 112 112 112 112 112 112 112 112 112 112 112 112 112 112 112 112 112 112 112 076 112 112 112 112 112 112 112 112 112 112 112 112 112 112 112 112 112 112 112 112 112 112 112 112 112 112 112 112 112 112 112 112 112 112 112 112 112 112 112 112 112 112 112 112 112 112 112 076 112 112 112 112 112 112 112 112 112 112 112 112 112 076 112 112 076 112 112 076 112 112 112 112 112 112 112 112 112 112 112 112 112 112 112 112 112 112 076 112 112 112 112 112 112 112 112 112 112 076 112
112 112 112 112 112 112 112 112 112 112 112 112 112 112 112 112 112 112 112 112 112 112 112 112 112 112 112 112 112 112 112 112 112 112 112 112 112 112 112 112 112 112 112 112 112 112 076 076 076 112 112 112 112 112 112 112 076 112 112 112 112 112 112 112 112 112 112 112 112 112 112 112 112 112 112 112 112 112 112 112 112 112 112 112 112 112 112 112 112 112 112 112 112 112 112 112 112 112 112 112 112 112 112 112 112 112 112 112 112 112 112 112 112 112 112 112 112 112 112 112 112 112 112 112 112 112 112 112 112 112 112 112 112 112 112 112 112 112 112 112 112 112 112 112 112 112 112 112 112 112 112 112 112 112 112 112 112 112 112 076 112 076 112 076 112 112 112 112 112 112 112 112 112 112 112 112 112 112 112 112 112 112 112 112 112 112 112 112 112 112 112 112 112 112 076 076 076 076 076 076 112 112 112 112 112 112 112 112 112 112 112 112 112 112 112 112 112 112 112 112 112 112 112 112 112 112 076 076 076 076 076 076 076 076 076 076 076 076 076 076 076 076 076 076 076 076 076 112 112 112 112 112 112 112 112 112 112 112 112 112 112 112 112 112 112 112 112 112 112 112 112 112 112 112 112 112 112 112 112 112 112 076 076 076 076 076 076 112 112 112 112 112 112 112 112 112 112 112 112 112
112 112 112 112 112 112 112 112 112 112 112 112 112 112 112 112 112 112 112 112 112 112 112 112 112 112 112 112 112 112 112 112 112 112 112 112 112 112 112 112 112 112 112 112 112 112 112 112 112 112 112 112 112 112 112 112 112 112 112 112 112 112 112 112 112 112 112 112 112 112 112 112 112 112 112 112 112 112 112 112 112 112 112 112 112 112 112 112 112 112 112 112 112 112 112 112 112 112 112 112 112 112 112 112 112 112 112 112 112 112 112 112 112 112 112 112 112 112 112 112 112 112 112 112 112 112 112 112 112 112 112 112 112 112 112 112 112 112 112 112 112 112 112 112 112 112 112 112 112 112 112 112 112 112 112 112 112 112 112 112 112 112 112 112 112 112 112 112 112 112 112 112 112 112 112 112 112 112 112 112 112 112 112 112 112 112 112 112 112 112 112 112 112 112 112 112 112 112 112 112 112 112 112 112 112 112 112 112 112 112 112 112 112 112 112 112 112 112 112 112 112 112 112 112 112 112 112 112 112 112 112 112 112 112 112 112 112 112 112 112 112 112 112 112 112 112 112 112 112 112 112 112 112 112 112 112 112 112 112 112 112 112 112 112 112 112 112 112 112 112 112 112 112 112 112 112 112 112 112 112 112 112 112 112 112 112 112 112 112 112 112 112 112 112 112 112 112 112 112 112