16 12
100 100
103 105 105 105 105 105 105 105 105 105 105 105 105 105 105 104
106 102 102 102 102 102 102 102 102 102 102 102 102 102 102 107
106 102 102 102 102 102 102 102 102 102 102 102 102 102 102 107
106 102 102 102 102 102 102 102 102 102 102 102 102 102 102 107
106 102 102 102 102 102 102 102 102 102 102 102 102 102 102 107
106 102 102 102 102 102 102 102 102 102 102 102 102 102 102 107
106 102 102 102 102 102 102 102 102 102 102 102 102 102 102 107
106 102 102 102 102 102 102 102 102 102 102 102 102 102 102 107
106 102 102 102 102 102 102 102 102 102 102 102 102 102 102 107
106 102 102 102 102 102 102 102 102 102 102 102 102 102 102 107
106 102 102 102 102 102 102 102 102 102 102 102 102 102 102 107
110 108 108 108 108 108 108 108 108 108 108 108 108 108 108 109