62 62
0 160
77 77 77 77 77 77 77 77 77 77 77 77 77 77 77 77 77 77 77 77 77 77 77 77 77 77 77 77 77 77 77 77 77 77 77 77 77 77 77 77 77 77 77 77 77 77 77 77 77 77 77 77 77 77 77 77 77 77 77 77 77 77
77 77 77 77 77 77 77 77 77 77 77 77 77 77 77 77 77 77 77 77 77 77 77 77 77 77 77 77 77 77 77 77 77 77 77 77 77 77 77 77 77 77 77 77 77 77 77 77 77 77 77 77 77 77 77 77 77 77 77 77 77 77
00 00 00 00 77 77 00 00 00 00 00 00 00 00 00 00 00 00 00 00 00 00 00 00 00 00 00 00 00 00 00 00 77 77 00 00 00 00 00 00 00 00 00 00 00 00 00 00 00 00 00 00 77 77 00 00 00 00 00 00 77 77
00 00 00 00 77 77 00 00 00 00 00 00 00 00 00 00 00 00 00 00 00 00 00 00 00 00 00 00 00 00 00 00 77 77 00 00 00 00 00 00 00 00 00 00 00 00 00 00 00 00 00 00 77 77 00 00 00 00 00 00 77 77
77 77 00 00 77 77 77 77 77 77 77 77 77 77 77 77 77 77 77 77 77 77 00 00 77 77 77 77 77 77 00 00 77 77 00 00 77 77 77 77 77 77 77 77 77 77 77 77 77 77 00 00 77 77 00 00 77 77 00 00 77 77
77 77 00 00 77 77 77 77 77 77 77 77 77 77 77 77 77 77 77 77 77 77 00 00 77 77 77 77 77 77 00 00 77 77 00 00 77 77 77 77 77 77 77 77 77 77 77 77 77 77 00 00 77 77 00 00 77 77 00 00 77 77
77 77 00 00 00 00 00 00 00 00 00 00 00 00 00 00 77 77 00 00 00 00 00 00 77 77 00 00 00 00 00 00 00 00 00 00 00 00 00 00 77 77 00 00 00 00 00 00 00 00 00 00 00 00 00 00 77 77 00 00 77 77
77 77 00 00 00 00 00 00 00 00 00 00 00 00 00 00 77 77 00 00 00 00 00 00 77 77 00 00 00 00 00 00 00 00 00 00 00 00 00 00 77 77 00 00 00 00 00 00 00 00 00 00 00 00 00 00 77 77 00 00 77 77
77 77 00 00 77 77 00 00 77 77 77 77 77 77 77 77 77 77 77 77 77 77 77 77 77 77 77 77 77 77 00 00 77 77 77 77 77 77 00 00 77 77 00 00 77 77 77 77 77 77 77 77 77 77 77 77 77 77 77 77 77 77
77 77 00 00 77 77 00 00 77 77 77 77 77 77 77 77 77 77 77 77 77 77 77 77 77 77 77 77 77 77 00 00 77 77 77 77 77 77 00 00 77 77 00 00 77 77 77 77 77 77 77 77 77 77 77 77 77 77 77 77 77 77
77 77 00 00 77 77 00 00 00 00 00 00 00 00 00 00 00 00 00 00 00 00 00 00 00 00 00 00 77 77 00 00 77 77 00 00 77 77 00 00 77 77 00 00 00 00 00 00 00 00 00 00 77 77 00 00 00 00 00 00 77 77
77 77 00 00 77 77 00 00 00 00 00 00 00 00 00 00 00 00 00 00 00 00 00 00 00 00 00 00 77 77 00 00 77 77 00 00 77 77 00 00 77 77 00 00 00 00 00 00 00 00 00 00 77 77 00 00 00 00 00 00 77 77
77 77 77 77 77 77 77 77 77 77 77 77 77 77 77 77 77 77 77 77 77 77 77 77 77 77 00 00 77 77 77 77 77 77 00 00 77 77 77 77 77 77 77 77 77 77 00 00 77 77 00 00 77 77 00 00 77 77 77 77 77 77
77 77 77 77 77 77 77 77 77 77 77 77 77 77 77 77 77 77 77 77 77 77 77 77 77 77 00 00 77 77 77 77 77 77 00 00 77 77 77 77 77 77 77 77 77 77 00 00 77 77 00 00 77 77 00 00 77 77 77 77 77 77
77 77 00 00 00 00 00 00 00 00 00 00 00 00 00 00 00 00 00 00 00 00 00 00 77 77 00 00 77 77 00 00 00 00 00 00 00 00 00 00 77 77 00 00 00 00 00 00 77 77 00 00 77 77 00 00 00 00 00 00 77 77
77 77 00 00 00 00 00 00 00 00 00 00 00 00 00 00 00 00 00 00 00 00 00 00 77 77 00 00 77 77 00 00 00 00 00 00 00 00 00 00 77 77 00 00 00 00 00 00 77 77 00 00 77 77 00 00 00 00 00 00 77 77
77 77 00 00 77 77 77 77 77 77 00 00 77 77 77 77 77 77 77 77 77 77 00 00 77 77 00 00 77 77 77 77 77 77 77 77 77 77 00 00 77 77 00 00 77 77 77 77 77 77 00 00 77 77 00 00 77 77 00 00 77 77
77 77 00 00 77 77 77 77 77 77 00 00 77 77 77 77 77 77 77 77 77 77 00 00 77 77 00 00 77 77 77 77 77 77 77 77 77 77 00 00 77 77 00 00 77 77 77 77 77 77 00 00 77 77 00 00 77 77 00 00 77 77
77 77 00 00 77 77 00 00 00 00 00 00 77 77 00 00 00 00 00 00 00 00 00 00 77 77 00 00 77 77 00 00 00 00 00 00 00 00 00 00 00 00 00 00 00 00 00 00 77 77 00 00 00 00 00 00 77 77 00 00 77 77
77 77 00 00 77 77 00 00 00 00 00 00 77 77 00 00 00 00 00 00 00 00 00 00 77 77 00 00 77 77 00 00 00 00 00 00 00 00 00 00 00 00 00 00 00 00 00 00 77 77 00 00 00 00 00 00 77 77 00 00 77 77
77 77 77 77 77 77 00 00 77 77 00 00 77 77 00 00 77 77 77 77 77 77 77 77 77 77 00 00 77 77 00 00 77 77 77 77 77 77 00 00 77 77 00 00 77 77 00 00 77 77 00 00 77 77 77 77 77 77 00 00 77 77
77 77 77 77 77 77 00 00 77 77 00 00 77 77 00 00 77 77 77 77 77 77 77 77 77 77 00 00 77 77 00 00 77 77 77 77 77 77 00 00 77 77 00 00 77 77 00 00 77 77 00 00 77 77 77 77 77 77 00 00 77 77
77 77 00 00 77 77 00 00 77 77 00 00 77 77 00 00 00 00 00 00 00 00 00 00 77 77 00 00 00 00 00 00 77 77 00 00 00 00 00 00 77 77 00 00 77 77 00 00 77 77 00 00 00 00 00 00 77 77 00 00 77 77
77 77 00 00 77 77 00 00 77 77 00 00 77 77 00 00 00 00 00 00 00 00 00 00 77 77 00 00 00 00 00 00 77 77 00 00 00 00 00 00 77 77 00 00 77 77 00 00 77 77 00 00 00 00 00 00 77 77 00 00 77 77
77 77 00 00 77 77 77 77 77 77 00 00 77 77 77 77 77 77 77 77 77 77 77 77 77 77 00 00 77 77 77 77 77 77 00 00 77 77 77 77 77 77 00 00 77 77 77 77 77 77 77 77 77 77 77 77 77 77 00 00 77 77
77 77 00 00 77 77 77 77 77 77 00 00 77 77 77 77 77 77 77 77 77 77 77 77 77 77 00 00 77 77 77 77 77 77 00 00 77 77 77 77 77 77 00 00 77 77 77 77 77 77 77 77 77 77 77 77 77 77 00 00 77 77
77 77 00 00 00 00 00 00 77 77 00 00 00 00 00 00 77 77 00 00 00 00 00 00 00 00 00 00 00 00 00 00 77 77 00 00 00 00 00 00 77 77 00 00 77 77 00 00 77 77 00 00 00 00 00 00 00 00 00 00 77 77
77 77 00 00 00 00 00 00 77 77 00 00 00 00 00 00 77 77 00 00 00 00 00 00 00 00 00 00 00 00 00 00 77 77 00 00 00 00 00 00 77 77 00 00 77 77 00 00 77 77 00 00 00 00 00 00 00 00 00 00 77 77
77 77 00 00 77 77 77 77 77 77 77 77 77 77 00 00 77 77 00 00 77 77 00 00 77 77 00 00 77 77 77 77 77 77 00 00 77 77 77 77 77 77 00 00 77 77 00 00 77 77 77 77 77 77 77 77 77 77 00 00 77 77
77 77 00 00 77 77 77 77 77 77 77 77 77 77 00 00 77 77 00 00 77 77 00 00 77 77 00 00 77 77 77 77 77 77 00 00 77 77 77 77 77 77 00 00 77 77 00 00 77 77 77 77 77 77 77 77 77 77 00 00 77 77
77 77 00 00 00 00 00 00 77 77 00 00 77 77 00 00 00 00 00 00 77 77 00 00 77 77 00 00 00 00 00 00 77 77 00 00 00 00 00 00 77 77 00 00 00 00 00 00 77 77 00 00 00 00 00 00 00 00 00 00 77 77
77 77 00 00 00 00 00 00 77 77 00 00 77 77 00 00 00 00 00 00 77 77 00 00 77 77 00 00 00 00 00 00 77 77 00 00 00 00 00 00 77 77 00 00 00 00 00 00 77 77 00 00 00 00 00 00 00 00 00 00 77 77
77 77 00 00 77 77 00 00 77 77 00 00 77 77 77 77 77 77 77 77 77 77 77 77 77 77 77 77 77 77 00 00 77 77 00 00 77 77 77 77 77 77 00 00 77 77 77 77 77 77 00 00 77 77 00 00 77 77 77 77 77 77
77 77 00 00 77 77 00 00 77 77 00 00 77 77 77 77 77 77 77 77 77 77 77 77 77 77 77 77 77 77 00 00 77 77 00 00 77 77 77 77 77 77 00 00 77 77 77 77 77 77 00 00 77 77 00 00 77 77 77 77 77 77
77 77 00 00 77 77 00 00 00 00 00 00 00 00 00 00 00 00 00 00 00 00 00 00 00 00 00 00 00 00 00 00 77 77 00 00 00 00 00 00 77 77 00 00 00 00 00 00 77 77 00 00 77 77 00 00 00 00 00 00 77 77
77 77 00 00 77 77 00 00 00 00 00 00 00 00 00 00 00 00 00 00 00 00 00 00 00 00 00 00 00 00 00 00 77 77 00 00 00 00 00 00 77 77 00 00 00 00 00 00 77 77 00 00 77 77 00 00 00 00 00 00 77 77
77 77 00 00 77 77 77 77 77 77 77 77 77 77 00 00 77 77 00 00 77 77 00 00 77 77 77 77 77 77 77 77 77 77 00 00 77 77 77 77 77 77 00 00 77 77 77 77 77 77 77 77 77 77 00 00 77 77 00 00 77 77
77 77 00 00 77 77 77 77 77 77 77 77 77 77 00 00 77 77 00 00 77 77 00 00 77 77 77 77 77 77 77 77 77 77 00 00 77 77 77 77 77 77 00 00 77 77 77 77 77 77 77 77 77 77 00 00 77 77 00 00 77 77
77 77 00 00 77 77 00 00 77 77 00 00 00 00 00 00 77 77 00 00 77 77 00 00 00 00 00 00 77 77 00 00 00 00 00 00 77 77 00 00 77 77 00 00 00 00 00 00 77 77 00 00 00 00 00 00 77 77 00 00 77 77
77 77 00 00 77 77 00 00 77 77 00 00 00 00 00 00 77 77 00 00 77 77 00 00 00 00 00 00 77 77 00 00 00 00 00 00 77 77 00 00 77 77 00 00 00 00 00 00 77 77 00 00 00 00 00 00 77 77 00 00 77 77
77 77 77 77 77 77 00 00 77 77 77 77 77 77 00 00 77 77 77 77 77 77 77 77 77 77 00 00 77 77 00 00 77 77 77 77 77 77 00 00 77 77 77 77 77 77 00 00 77 77 00 00 77 77 77 77 77 77 00 00 77 77
77 77 77 77 77 77 00 00 77 77 77 77 77 77 00 00 77 77 77 77 77 77 77 77 77 77 00 00 77 77 00 00 77 77 77 77 77 77 00 00 77 77 77 77 77 77 00 00 77 77 00 00 77 77 77 77 77 77 00 00 77 77
77 77 00 00 00 00 00 00 00 00 00 00 77 77 00 00 77 77 00 00 00 00 00 00 00 00 00 00 77 77 00 00 00 00 00 00 00 00 00 00 77 77 00 00 00 00 00 00 77 77 00 00 00 00 00 00 77 77 00 00 77 77
77 77 00 00 00 00 00 00 00 00 00 00 77 77 00 00 77 77 00 00 00 00 00 00 00 00 00 00 77 77 00 00 00 00 00 00 00 00 00 00 77 77 00 00 00 00 00 00 77 77 00 00 00 00 00 00 77 77 00 00 77 77
77 77 00 00 77 77 77 77 77 77 00 00 77 77 77 77 77 77 77 77 77 77 00 00 77 77 00 00 77 77 00 00 77 77 77 77 77 77 77 77 77 77 00 00 77 77 77 77 77 77 77 77 77 77 00 00 77 77 77 77 77 77
77 77 00 00 77 77 77 77 77 77 00 00 77 77 77 77 77 77 77 77 77 77 00 00 77 77 00 00 77 77 00 00 77 77 77 77 77 77 77 77 77 77 00 00 77 77 77 77 77 77 77 77 77 77 00 00 77 77 77 77 77 77
77 77 00 00 00 00 00 00 77 77 00 00 77 77 00 00 00 00 00 00 77 77 00 00 77 77 00 00 77 77 00 00 00 00 00 00 00 00 00 00 77 77 00 00 00 00 00 00 00 00 00 00 77 77 00 00 00 00 00 00 77 77
77 77 00 00 00 00 00 00 77 77 00 00 77 77 00 00 00 00 00 00 77 77 00 00 77 77 00 00 77 77 00 00 00 00 00 00 00 00 00 00 77 77 00 00 00 00 00 00 00 00 00 00 77 77 00 00 00 00 00 00 77 77
77 77 77 77 77 77 77 77 77 77 00 00 77 77 00 00 77 77 77 77 77 77 00 00 77 77 00 00 77 77 77 77 77 77 77 77 77 77 77 77 77 77 00 00 77 77 77 77 77 77 00 00 77 77 77 77 77 77 00 00 77 77
77 77 77 77 77 77 77 77 77 77 00 00 77 77 00 00 77 77 77 77 77 77 00 00 77 77 00 00 77 77 77 77 77 77 77 77 77 77 77 77 77 77 00 00 77 77 77 77 77 77 00 00 77 77 77 77 77 77 00 00 77 77
77 77 00 00 00 00 00 00 00 00 00 00 77 77 00 00 77 77 00 00 00 00 00 00 77 77 00 00 00 00 00 00 00 00 00 00 77 77 00 00 77 77 00 00 77 77 00 00 77 77 00 00 77 77 00 00 77 77 00 00 77 77
77 77 00 00 00 00 00 00 00 00 00 00 77 77 00 00 77 77 00 00 00 00 00 00 77 77 00 00 00 00 00 00 00 00 00 00 77 77 00 00 77 77 00 00 77 77 00 00 77 77 00 00 77 77 00 00 77 77 00 00 77 77
77 77 77 77 77 77 77 77 77 77 00 00 77 77 00 00 77 77 77 77 77 77 00 00 77 77 00 00 77 77 77 77 77 77 00 00 77 77 00 00 77 77 77 77 77 77 00 00 77 77 77 77 77 77 00 00 77 77 00 00 77 77
77 77 77 77 77 77 77 77 77 77 00 00 77 77 00 00 77 77 77 77 77 77 00 00 77 77 00 00 77 77 77 77 77 77 00 00 77 77 00 00 77 77 77 77 77 77 00 00 77 77 77 77 77 77 00 00 77 77 00 00 77 77
77 77 00 00 00 00 00 00 77 77 00 00 00 00 00 00 00 00 00 00 77 77 00 00 77 77 00 00 77 77 00 00 77 77 00 00 00 00 00 00 00 00 00 00 00 00 00 00 77 77 00 00 00 00 00 00 77 77 00 00 77 77
77 77 00 00 00 00 00 00 77 77 00 00 00 00 00 00 00 00 00 00 77 77 00 00 77 77 00 00 77 77 00 00 77 77 00 00 00 00 00 00 00 00 00 00 00 00 00 00 77 77 00 00 00 00 00 00 77 77 00 00 77 77
77 77 00 00 77 77 00 00 77 77 00 00 77 77 77 77 77 77 77 77 77 77 00 00 77 77 77 77 77 77 00 00 77 77 77 77 77 77 77 77 77 77 77 77 77 77 00 00 77 77 00 00 77 77 00 00 77 77 77 77 77 77
77 77 00 00 77 77 00 00 77 77 00 00 77 77 77 77 77 77 77 77 77 77 00 00 77 77 77 77 77 77 00 00 77 77 77 77 77 77 77 77 77 77 77 77 77 77 00 00 77 77 00 00 77 77 00 00 77 77 77 77 77 77
77 77 00 00 77 77 00 00 00 00 00 00 00 00 00 00 00 00 00 00 77 77 00 00 77 77 00 00 00 00 00 00 00 00 00 00 00 00 00 00 00 00 00 00 00 00 00 00 00 00 00 00 77 77 00 00 00 00 00 00 00 00
77 77 00 00 77 77 00 00 00 00 00 00 00 00 00 00 00 00 00 00 77 77 00 00 77 77 00 00 00 00 00 00 00 00 00 00 00 00 00 00 00 00 00 00 00 00 00 00 00 00 00 00 77 77 00 00 00 00 00 00 00 00
77 77 77 77 77 77 77 77 77 77 77 77 77 77 77 77 77 77 77 77 77 77 77 77 77 77 77 77 77 77 77 77 77 77 77 77 77 77 77 77 77 77 77 77 77 77 77 77 77 77 77 77 77 77 77 77 77 77 77 77 77 77
77 77 77 77 77 77 77 77 77 77 77 77 77 77 77 77 77 77 77 77 77 77 77 77 77 77 77 77 77 77 77 77 77 77 77 77 77 77 77 77 77 77 77 77 77 77 77 77 77 77 77 77 77 77 77 77 77 77 77 77 77 77