64 19
100 100
94 93 94 93 94 93 94 93 94 93 94 93 94 93 94 93 94 93 94 93 94 93 94 93 94 93 94 93 94 93 94 93 94 93 94 93 94 93 94 93 94 93 94 93 94 93 94 93 94 93 94 93 94 93 94 93 94 93 94 93 94 93 94 93
98 97 98 97 98 97 98 97 98 97 98 97 98 97 98 97 93 94 93 94 93 94 93 94 98 97 98 97 98 97 98 97 98 97 98 97 98 97 98 97 93 94 93 94 93 94 93 94 98 97 98 97 98 97 98 97 98 97 98 97 98 97 98 97
96 00 00 00 00 00 00 00 00 00 00 00 00 00 00 95 94 93 94 93 94 93 94 93 96 00 00 00 00 00 00 00 00 00 00 00 00 00 00 95 94 93 94 93 94 93 94 93 96 00 00 00 00 00 00 00 00 00 00 00 00 00 00 95
98 00 00 00 00 00 00 00 00 00 00 00 00 00 00 97 93 94 93 94 93 94 93 94 98 00 00 00 00 00 00 00 00 00 00 00 00 00 00 97 93 94 93 94 93 94 93 94 98 00 00 00 00 00 00 00 00 00 00 00 00 00 00 97
96 00 00 00 00 00 00 00 00 00 00 00 00 00 00 95 94 93 94 93 94 93 94 93 96 00 00 00 00 00 00 00 00 00 00 00 00 00 00 95 94 93 94 93 94 93 94 93 96 00 00 00 00 00 00 00 00 00 00 00 00 00 00 95
98 00 00 00 00 00 00 00 00 00 00 00 00 00 00 97 93 94 93 94 93 94 93 94 98 00 00 00 00 00 00 00 00 00 00 00 00 00 00 97 93 94 93 94 93 94 93 94 98 00 00 00 00 00 00 00 00 00 00 00 00 00 00 97
96 00 00 00 00 00 00 00 00 00 00 00 00 00 00 95 94 93 94 93 94 93 94 93 96 00 00 00 00 00 00 00 00 00 00 00 00 00 00 95 94 93 94 93 94 93 94 93 96 00 00 00 00 00 00 00 00 00 00 00 00 00 00 95
98 00 00 00 00 00 00 00 00 00 00 00 00 00 00 97 93 94 93 94 93 94 93 94 98 00 00 00 00 00 00 00 00 00 00 00 00 00 00 97 93 94 93 94 93 94 93 94 98 00 00 00 00 00 00 00 00 00 00 00 00 00 00 97
96 00 00 00 00 00 00 00 00 00 00 00 00 00 00 95 94 93 94 93 94 93 94 93 96 00 00 00 00 00 00 00 00 00 00 00 00 00 00 95 94 93 94 93 94 93 94 93 96 00 00 00 00 00 00 00 00 00 00 00 00 00 00 95
98 00 00 00 00 00 00 00 00 00 00 00 00 00 00 97 93 94 93 94 93 94 93 94 98 00 00 00 00 00 00 00 00 00 00 00 00 00 00 97 93 94 93 94 93 94 93 94 98 00 00 00 00 00 00 00 00 00 00 00 00 00 00 97
96 00 00 00 00 00 00 00 00 00 00 00 00 00 00 95 94 93 94 93 94 93 94 93 96 00 00 00 00 00 00 00 00 00 00 00 00 00 00 95 94 93 94 93 94 93 94 93 96 00 00 00 00 00 00 00 00 00 00 00 00 00 00 95
98 00 00 00 00 00 00 00 00 00 00 00 00 00 00 97 93 94 93 94 93 94 93 94 98 00 00 00 00 00 00 00 00 00 00 00 00 00 00 97 93 94 93 94 93 94 93 94 98 00 00 00 00 00 00 00 00 00 00 00 00 00 00 97
96 95 96 95 96 95 96 00 00 95 96 95 96 95 96 95 94 93 94 93 94 93 94 93 96 95 96 95 96 95 96 00 00 95 96 95 96 95 96 95 94 93 94 93 94 93 94 93 96 95 96 95 96 95 96 00 00 95 96 95 96 95 96 95
93 94 93 94 93 94 98 00 00 97 93 94 93 94 93 94 93 94 93 94 93 94 93 94 93 94 93 94 93 94 98 00 00 97 93 94 93 94 93 94 93 94 93 94 93 94 93 94 93 94 93 94 93 94 98 00 00 97 93 94 93 94 93 94
94 93 94 93 94 93 96 00 00 95 94 93 94 93 94 93 94 93 94 93 94 93 94 93 94 93 94 93 94 93 96 00 00 95 94 93 94 93 94 93 94 93 94 93 94 93 94 93 94 93 94 93 94 93 96 00 00 95 94 93 94 93 94 93
98 97 98 97 98 97 98 00 00 97 98 97 98 97 98 97 98 97 98 97 98 97 98 97 98 97 98 97 98 97 98 00 00 97 98 97 98 97 98 97 98 97 98 97 98 97 98 97 98 97 98 97 98 97 98 00 00 97 98 97 98 97 98 97
96 00 00 00 00 00 00 00 00 00 00 00 00 00 00 00 00 00 00 00 00 00 00 00 00 00 00 00 00 00 00 00 00 00 00 00 00 00 00 00 00 00 00 00 00 00 00 00 00 00 00 00 00 00 00 00 00 00 00 00 00 00 00 95
98 00 00 00 00 00 00 00 00 00 00 00 00 00 00 00 00 00 00 00 00 00 00 00 00 00 00 00 00 00 00 00 00 00 00 00 00 00 00 00 00 00 00 00 00 00 00 00 00 00 00 00 00 00 00 00 00 00 00 00 00 00 00 97
96 95 96 95 96 95 96 95 96 95 96 95 96 95 96 95 96 95 96 95 96 95 96 95 96 95 96 95 96 95 96 95 96 95 96 95 96 95 96 95 96 95 96 95 96 95 96 95 96 95 96 95 96 95 96 95 96 95 96 95 96 95 96 95