16 150
100 100
113 114 117 117 117 117 118 118 117 117 118 118 117 117 113 114
113 114 117 117 117 117 118 118 117 117 118 118 117 117 113 114
113 114 118 118 118 118 118 118 117 117 118 118 117 117 113 114
113 114 118 118 118 118 118 118 117 117 118 118 118 118 113 114
113 114 117 117 117 117 117 117 117 117 118 118 118 118 113 114
113 114 117 117 117 117 117 117 117 117 117 117 117 117 113 114
113 114 117 117 117 117 117 117 117 117 117 117 117 117 113 114
113 114 117 117 117 117 117 117 118 118 117 117 117 117 113 114
113 114 117 117 117 117 117 117 118 118 117 117 117 117 113 114
113 114 117 117 117 117 117 117 117 117 118 118 117 117 113 114
113 114 117 117 117 117 117 117 117 117 118 118 117 117 113 114
113 114 117 117 117 117 118 118 117 117 117 117 117 117 113 114
113 114 117 117 117 117 118 118 117 117 117 117 117 117 113 114
113 114 117 117 117 117 117 117 117 117 117 117 117 117 113 114
113 114 117 117 118 118 117 117 117 117 117 117 117 117 113 114
113 114 117 117 118 118 117 117 117 117 117 117 117 117 113 114
113 114 117 117 117 117 117 117 117 117 117 117 117 117 113 114
113 114 118 118 117 117 117 117 117 117 117 117 117 117 113 114
113 114 118 118 117 117 117 117 117 117 117 117 117 117 113 114
113 114 117 117 117 117 117 117 117 117 117 117 117 117 113 114
113 114 117 117 117 117 117 117 117 117 117 117 117 117 113 114
113 114 117 117 117 117 117 117 117 117 117 117 117 117 113 114
113 114 117 117 118 118 117 117 117 117 117 117 117 117 113 114
113 114 117 117 118 118 118 118 117 117 117 117 117 117 113 114
113 114 117 117 117 117 118 118 118 118 117 117 117 117 113 114
113 114 117 117 117 117 117 117 118 118 117 117 117 117 113 114
113 114 117 117 117 117 117 117 118 118 117 117 117 117 113 114
113 114 117 117 117 117 117 117 117 117 118 118 117 117 113 114
113 114 117 117 117 117 117 117 117 117 118 118 117 117 113 114
113 114 117 117 117 117 117 117 117 117 117 117 118 118 113 114
113 114 117 117 117 117 117 117 117 117 117 117 118 118 113 114
113 114 117 117 117 117 117 117 117 117 117 117 117 117 113 114
113 114 117 117 117 117 117 117 117 117 117 117 117 117 113 114
113 114 117 117 118 118 117 117 117 117 118 118 117 117 113 114
113 114 117 117 118 118 117 117 117 117 118 118 117 117 113 114
113 114 117 117 117 117 117 117 117 117 118 118 117 117 113 114
113 114 117 117 117 117 117 117 117 117 117 117 117 117 113 114
113 114 117 117 117 117 118 118 117 117 117 117 117 117 113 114
113 114 117 117 117 117 118 118 117 117 117 117 118 118 113 114
113 114 117 117 117 117 118 118 117 117 117 117 118 118 113 114
113 114 117 117 117 117 117 117 117 117 117 117 117 117 113 114
113 114 117 117 117 117 117 117 117 117 117 117 117 117 113 114
113 114 117 117 117 117 117 117 117 117 117 117 117 117 113 114
113 114 117 117 117 117 117 117 117 117 118 118 117 117 113 114
113 114 117 117 117 117 117 117 117 117 118 118 117 117 113 114
113 114 118 118 117 117 117 117 118 118 117 117 117 117 113 114
113 114 118 118 117 117 117 117 118 118 117 117 117 117 113 114
113 114 117 117 117 117 118 118 117 117 117 117 117 117 113 114
113 114 117 117 117 117 118 118 117 117 117 117 117 117 113 114
113 114 117 117 117 117 117 117 117 117 117 117 117 117 113 114
113 114 117 117 117 117 117 117 117 117 118 118 117 117 113 114
113 114 117 117 118 118 117 117 117 117 118 118 117 117 113 114
113 114 117 117 118 118 117 117 117 117 117 117 117 117 113 114
113 114 117 117 117 117 117 117 117 117 117 117 117 117 113 114
113 114 117 117 117 117 117 117 117 117 117 117 117 117 113 114
113 114 117 117 117 117 118 118 117 117 117 117 118 118 113 114
113 114 117 117 117 117 118 118 117 117 117 117 118 118 113 114
113 114 117 117 117 117 118 118 117 117 117 117 117 117 113 114
113 114 117 117 117 117 117 117 117 117 117 117 117 117 113 114
113 114 117 117 117 117 117 117 117 117 118 118 117 117 113 114
113 114 117 117 117 117 117 117 117 117 118 118 117 117 113 114
113 114 117 117 118 118 117 117 118 118 117 117 117 117 113 114
113 114 117 117 118 118 117 117 118 118 117 117 117 117 113 114
113 114 117 117 118 118 117 117 118 118 117 117 117 117 113 114
113 114 117 117 118 118 117 117 118 118 117 117 117 117 113 114
113 114 117 117 118 118 117 117 118 118 117 117 117 117 113 114
113 114 118 118 117 117 117 117 117 117 117 117 117 117 113 114
113 114 118 118 117 117 117 117 117 117 117 117 117 117 113 114
113 114 118 118 117 117 117 117 117 117 117 117 117 117 113 114
113 114 117 117 117 117 117 117 117 117 118 118 117 117 113 114
113 114 117 117 117 117 117 117 117 117 118 118 117 117 113 114
113 114 117 117 117 117 117 117 117 117 118 118 117 117 113 114
113 114 117 117 118 118 117 117 117 117 118 118 117 117 113 114
113 114 117 117 118 118 117 117 117 117 117 117 117 117 113 114
113 114 117 117 118 118 117 117 117 117 117 117 117 117 113 114
113 114 117 117 118 118 118 118 117 117 117 117 117 117 113 114
113 114 117 117 117 117 118 118 117 117 117 117 117 117 113 114
113 114 117 117 117 117 117 117 117 117 117 117 117 117 113 114
113 114 117 117 117 117 117 117 117 117 117 117 117 117 113 114
113 114 117 117 117 117 117 117 118 118 117 117 117 117 113 114
113 114 117 117 117 117 117 117 118 118 117 117 117 117 113 114
113 114 117 117 117 117 117 117 118 118 117 117 117 117 113 114
113 114 118 118 118 118 117 117 118 118 117 117 118 118 113 114
113 114 118 118 118 118 117 117 117 117 117 117 118 118 113 114
113 114 117 117 117 117 117 117 117 117 117 117 118 118 113 114
113 114 117 117 117 117 117 117 117 117 117 117 117 117 113 114
113 114 117 117 117 117 117 117 117 117 117 117 117 117 113 114
113 114 117 117 117 117 117 117 117 117 118 118 117 117 113 114
113 114 117 117 117 117 117 117 117 117 118 118 117 117 113 114
113 114 117 117 117 117 117 117 117 117 118 118 117 117 113 114
113 114 117 117 117 117 118 118 117 117 118 118 117 117 113 114
113 114 117 117 117 117 118 118 117 117 117 117 117 117 113 114
113 114 117 117 117 117 117 117 117 117 117 117 117 117 113 114
113 114 117 117 117 117 117 117 117 117 117 117 117 117 113 114
113 114 117 117 118 118 117 117 118 118 117 117 117 117 113 114
113 114 117 117 118 118 117 117 118 118 117 117 117 117 113 114
113 114 117 117 118 118 117 117 118 118 117 117 117 117 113 114
113 114 117 117 117 117 117 117 118 118 118 118 117 117 113 114
113 114 117 117 117 117 117 117 118 118 118 118 117 117 113 114
113 114 118 118 117 117 117 117 117 117 117 117 117 117 113 114
113 114 118 118 117 117 117 117 117 117 117 117 117 117 113 114
113 114 117 117 117 117 118 118 117 117 117 117 118 118 113 114
113 114 117 117 117 117 118 118 117 117 117 117 118 118 113 114
113 114 117 117 117 117 118 118 117 117 117 117 117 117 113 114
113 114 117 117 118 118 117 117 117 117 117 117 117 117 113 114
113 114 117 117 118 118 117 117 117 117 118 118 117 117 113 114
113 114 117 117 118 118 117 117 117 117 118 118 117 117 113 114
113 114 117 117 117 117 117 117 117 117 117 117 117 117 113 114
113 114 117 117 117 117 117 117 117 117 117 117 117 117 113 114
113 114 117 117 117 117 117 117 118 118 117 117 118 118 113 114
113 114 118 118 117 117 117 117 118 118 117 117 118 118 113 114
113 114 118 118 117 117 117 117 117 117 117 117 117 117 113 114
113 114 117 117 117 117 117 117 117 117 117 117 117 117 113 114
113 114 117 117 117 117 117 117 117 117 117 117 117 117 113 114
113 114 117 117 117 117 117 117 117 117 118 118 117 117 113 114
113 114 117 117 118 118 117 117 117 117 118 118 117 117 113 114
113 114 117 117 118 118 117 117 117 117 117 117 117 117 113 114
113 114 117 117 117 117 117 117 117 117 117 117 117 117 113 114
113 114 117 117 117 117 117 117 117 117 117 117 117 117 113 114
113 114 117 117 117 117 118 118 118 118 117 117 117 117 113 114
113 114 117 117 117 117 118 118 118 118 117 117 117 117 113 114
113 114 117 117 117 117 117 117 117 117 117 117 117 117 113 114
113 114 117 117 117 117 117 117 117 117 117 117 117 117 113 114
113 114 117 117 117 117 117 117 117 117 117 117 117 117 113 114
113 114 117 117 117 117 117 117 117 117 118 118 118 118 113 114
113 114 117 117 117 117 117 117 117 117 118 118 118 118 113 114
113 114 117 117 117 117 117 117 117 117 117 117 118 118 113 114
113 114 117 117 117 117 117 117 117 117 117 117 118 118 113 114
113 114 117 117 118 118 117 117 117 117 117 117 118 118 113 114
113 114 117 117 118 118 117 117 117 117 117 117 118 118 113 114
113 114 117 117 118 118 117 117 117 117 117 117 118 118 113 114
113 114 117 117 117 117 117 117 117 117 117 117 117 117 113 114
113 114 117 117 117 117 117 117 117 117 117 117 117 117 113 114
113 114 117 117 117 117 117 117 117 117 117 117 117 117 113 114
113 114 117 117 117 117 118 118 117 117 118 118 117 117 113 114
113 114 117 117 117 117 118 118 117 117 118 118 117 117 113 114
113 114 117 117 117 117 117 117 118 118 117 117 117 117 113 114
113 114 117 117 117 117 117 117 118 118 117 117 117 117 113 114
113 114 117 117 117 117 117 117 118 118 117 117 117 117 113 114
113 114 117 117 117 117 117 117 118 118 117 117 117 117 113 114
113 114 117 117 117 117 117 117 117 117 117 117 117 117 113 114
113 114 117 117 117 117 117 117 117 117 117 117 117 117 113 114
113 114 117 117 117 117 117 117 117 117 117 117 117 117 113 114
113 114 117 117 117 117 118 118 117 117 118 118 117 117 113 114
113 114 118 118 118 118 118 118 117 117 118 118 118 118 113 114
113 114 117 117 117 117 117 117 117 117 117 117 117 117 113 114
113 114 117 117 117 117 117 117 117 117 117 117 117 117 113 114
113 114 117 117 117 117 117 117 117 117 117 117 117 117 113 114
113 114 117 117 117 117 117 117 117 117 117 117 117 117 113 114
113 114 117 117 117 117 117 117 117 117 117 117 117 117 113 114